Algieria: Z ludu i dla ludu
Angola: Moc jest silniejsza
Benin: Braterstwo, Sprawiedliwoœæ, Praca
Botswana: Deszcz
Burkina Faso: Jednoœæ, postêp, sprawiedliwoœæ
Burundi: Jednoœæ, praca, postêp
Czad: Jednoœæ, Praca, Postêp
Demokratyczna Republika Konga: Demokracja – Sprawiedliwoœæ – Jednoœæ
D¿ibuti: Jednoœæ, równoœæ, pokój
Egipt: Gdzie to wszystko siê zaczyna
Erytrea: Zwyciêstwo dla mas
Eswatini: Jesteœmy twierdz¹
Etiopia: brak
Gabon: Jednoœæ, praca, praworz¹dnoœæ
Gambia: Postêp, Pokój, Dobrobyt
Ghana: Wolnoœæ i Sprawiedliwoœæ
Gwinea: Praca, sprawiedliwoœæ, solidarnoœæ
Gwinea Bissau: Jednoœæ, walka, rozwój
Gwinea Równikowa: Jednoœæ, pokój, sprawiedliwoœæ
Kamerun: Pokój, Praca, Ojczyzna
Kenia: Pracujmy razem
Komory: Jednoœæ - Solidarnoœæ - Rozwój
Kongo: Jednoœæ, Praca, Postêp
Lesotho: Pokój, deszcz, obfitoœæ
Liberia: Przynios³o nas tutaj umi³owanie wolnoœci
Libia: Wolnoœæ, sprawiedliwoœæ, demokracja
Madagaskar: Ojczyzna, Wolnoœæ, Postêp
Malawi: Jednoœæ i wolnoœæ
Mali: Jeden naród, jeden cel, jedna wiara
Maroko: Bóg, Ojczyzna, Król
Mauretania: Honor, braterstwo, sprawiedliwoœæ
Mauritius: Gwiazda i klucz do Oceanu Indyjskiego
Mozambik: Republika Mozambiku
Namibia: Jednoœæ, wolnoœæ, sprawiedliwoœæ
Niger: Braterstwo, Praca, Postêp
Nigeria: Pokój i jednoœæ, si³a i postêp
Po³udniowa Afryka: Ró¿norodni ludzie ³¹czcie siê
Republika Œrodkowoafrykañska: Jednoœæ, Godnoœæ, Praca
Republika Zielonego Przyl¹dka: Jednoœæ, Praca, Postêp
Rwanda: Jednoœæ, Praca, Patriotyzm
Sahara Zachodnia: Wolnoœæ, Demokracja, Jednoœæ
Senegal: Jeden naród, jeden cel, jedna wiara
Seszele: Koniec wieñczy dzie³o
Sierra Leone: Jednoœæ – Wolnoœæ – Sprawiedliwoœæ
Somalia: brak
Sudan Po³udniowy: Sprawiedliwoœæ, wolnoœæ, dobrobyt
Sudan: Zwyciêstwo jest nasze
Tanzania: Wolnoœæ i jednoœæ
Togo: Jednoœæ, pokój, solidarnoœæ
Tunezja: Wolnoœæ, dyscyplina, sprawiedliwoœæ
Uganda: Dla Boga i ojczyzny
Wybrze¿e Koœci S³oniowej: Jednoœæ, Dyscyplina, Praca
Wyspy Œwiêtego Tomasza i Ksi¹¿êca: Jednoœæ, dyscyplina, praca
Zambia: Jedna Zambia, jeden naród
Zimbabwe: Jednoœæ, wolnoœæ, praca
